11111111111111111111
10000000000000000001
1P0000000C0000000E01
11111111111111111111