1111111
1P00001
1111C01
1000001
1011101
1E000C1
1111111