111111111
1P00000E1
11111C011
1000C0001
101111101
1E0000C01
111111111